"DoY","CalD"
"1","Jan."
"32","Feb."
"60","Mar."
"91","Apr."
"121","May"
"152","Jun."
"182","Jul."
"213","Aug."
"244","Sept."
"274","Oct."
"305","Nov."
"335","Dec."
"366","Jan."
"397","Feb."
"425","Mar."
